"id","arrival","burst","wait","burst","turn"
"1","0","10","201","10","211"
"2","1","10","318","10","328"
"3","2","3","14","3","17"
"4","3","4","24","4","28"
"5","4","3","29","3","32"
"6","5","7","363","7","370"
"7","6","9","1125","9","1134"
"8","7","6","164","6","170"
"9","8","10","1407","10","1417"
"10","9","7","599","7","606"
"11","10","10","1771","10","1781"
"12","11","2","20","2","22"
"13","12","10","2047","10","2057"
"14","13","10","2190","10","2200"
"15","14","3","95","3","98"
"16","15","8","916","8","924"
"17","16","4","110","4","114"
"18","17","10","2726","10","2736"
"19","18","11","4084","11","4095"
"20","19","7","1165","7","1172"
"21","20","4","142","4","146"
"22","21","5","442","5","447"
"23","22","2","40","2","42"
"24","23","10","2977","10","2987"
"25","24","4","171","4","175"
"26","25","8","1475","8","1483"
"27","26","9","3139","9","3148"
"28","27","4","190","4","194"
"29","28","6","595","6","601"
"30","29","7","1709","7","1716"
"31","30","9","3324","9","3333"
"32","31","4","219","4","223"
"33","32","12","4538","12","4550"
"34","33","6","684","6","690"
"35","34","2","60","2","62"
"36","35","2","61","2","63"
"37","36","4","246","4","250"
"38","37","3","251","3","254"
"39","38","1","66","1","67"
"40","39","10","3640","10","3650"
"41","40","3","267","3","270"
"42","41","7","2308","7","2315"
"43","42","12","4811","12","4823"
"44","43","4","288","4","292"
"45","44","7","2447","7","2454"
"46","45","6","906","6","912"
"47","46","2","80","2","82"
"48","47","2","83","2","85"
"49","48","6","951","6","957"
"50","49","2","87","2","89"
"51","50","10","4006","10","4016"
"52","51","4","341","4","345"
"53","52","9","4045","9","4054"
"54","53","2","95","2","97"
"55","54","9","4061","9","4070"
"56","55","9","4076","9","4085"
"57","56","6","1113","6","1119"
"58","57","9","4109","9","4118"
"59","58","2","104","2","106"
"60","59","1","107","1","108"
"61","60","10","4131","10","4141"
"62","61","12","5087","12","5099"
"63","62","3","414","3","417"
"64","63","3","420","3","423"
"65","64","12","5107","12","5119"
"66","65","12","5112","12","5124"
"67","66","4","434","4","438"
"68","67","5","1318","5","1323"
"69","68","9","4211","9","4220"
"70","69","5","1367","5","1372"
"71","70","2","125","2","127"
"72","71","12","5151","12","5163"
"73","72","5","1417","5","1422"
"74","73","9","4269","9","4278"
"75","74","4","491","4","495"
"76","75","6","1490","6","1496"
"77","76","1","137","1","138"
"78","77","4","511","4","515"
"79","78","1","140","1","141"
"80","79","4","521","4","525"
"81","80","9","4344","9","4353"
"82","81","9","4366","9","4375"
"83","82","1","147","1","148"
"84","83","6","1635","6","1641"
"85","84","1","150","1","151"
"86","85","11","5254","11","5265"
"87","86","4","565","4","569"
"88","87","4","575","4","579"
"89","88","1","157","1","158"
"90","89","11","5287","11","5298"
"91","90","11","5293","11","5304"
"92","91","2","163","2","165"
"93","92","7","3309","7","3316"
"94","93","11","5315","11","5326"
"95","94","4","619","4","623"
"96","95","11","5329","11","5340"
"97","96","9","4532","9","4541"
"98","97","4","640","4","644"
"99","98","6","1915","6","1921"
"100","99","7","3413","7","3420"
"101","100","7","3422","7","3429"
"102","101","8","3440","8","3448"
"103","102","7","3454","7","3461"
"104","103","7","3476","7","3483"
"105","104","11","5385","11","5396"
"106","105","9","4613","9","4622"
"107","106","2","187","2","189"
"108","107","11","5397","11","5408"
"109","108","3","711","3","714"
"110","109","7","3559","7","3566"
"111","110","4","726","4","730"
"112","111","5","2175","5","2180"
"113","112","4","737","4","741"
"114","113","5","2207","5","2212"
"115","114","3","747","3","750"
"116","115","2","203","2","205"
"117","116","10","4733","10","4743"
"118","117","2","207","2","209"
"119","118","1","208","1","209"
"120","119","3","777","3","780"
"121","120","6","2329","6","2335"
"122","121","2","214","2","216"
"123","122","2","215","2","217"
"124","123","3","801","3","804"
"125","124","10","4808","10","4818"
"126","125","11","5528","11","5539"
"127","126","6","2445","6","2451"
"128","127","3","832","3","835"
"129","128","11","5557","11","5568"
"130","129","3","841","3","844"
"131","130","6","2517","6","2523"
"132","131","11","5567","11","5578"
"133","132","8","3886","8","3894"
"134","133","2","232","2","234"
"135","134","10","4913","10","4923"
"136","135","4","871","4","875"
"137","136","1","237","1","238"
"138","137","3","879","3","882"
"139","138","2","239","2","241"
"140","139","11","5578","11","5589"
"141","140","3","890","3","893"
"142","141","5","2595","5","2600"
"143","142","9","4921","9","4930"
"144","143","1","248","1","249"
"145","144","10","4928","10","4938"
"146","145","11","5581","11","5592"
"147","146","11","5581","11","5592"
"148","147","2","255","2","257"
"149","148","1","256","1","257"
"150","149","9","4945","9","4954"
"151","150","2","259","2","261"
"152","151","9","4944","9","4953"
"153","152","7","3962","7","3969"
"154","153","5","2659","5","2664"
"155","154","2","265","2","267"
"156","155","3","987","3","990"
"157","156","6","2673","6","2679"
"158","157","7","3981","7","3988"
"159","158","9","4952","9","4961"
"160","159","3","1018","3","1021"
"161","160","9","4957","9","4966"
"162","161","9","4959","9","4968"
"163","162","8","4000","8","4008"
"164","163","3","1048","3","1051"
"165","164","3","1052","3","1055"
"166","165","5","2719","5","2724"
"167","166","9","4967","9","4976"
"168","167","5","2727","5","2732"
"169","168","8","4015","8","4023"
"170","169","8","4020","8","4028"
"171","170","8","4027","8","4035"
"172","171","10","4967","10","4977"
"173","172","4","1099","4","1103"
"174","173","7","4038","7","4045"
"175","174","5","2763","5","2768"
"176","175","12","5588","12","5600"
"177","176","1","303","1","304"
"178","177","10","4983","10","4993"
"179","178","4","1133","4","1137"
"180","179","1","305","1","306"
"181","180","10","4987","10","4997"
"182","181","7","4057","7","4064"
"183","182","6","2792","6","2798"
"184","183","2","311","2","313"
"185","184","2","314","2","316"
"186","185","3","1173","3","1176"
"187","186","1","318","1","319"
"188","187","7","4075","7","4082"
"189","188","1","321","1","322"
"190","189","2","321","2","323"
"191","190","11","5593","11","5604"
"192","191","11","5593","11","5604"
"193","192","6","2839","6","2845"
"194","193","11","5594","11","5605"
"195","194","3","1233","3","1236"
"196","195","11","5593","11","5604"
"197","196","8","4103","8","4111"
"198","197","7","4106","7","4113"
"199","198","2","338","2","340"
"200","199","3","1260","3","1263"
"201","200","4","1263","4","1267"
"202","201","7","4112","7","4119"
"203","202","3","1279","3","1282"
"204","203","3","1283","3","1286"
"205","204","4","1292","4","1296"
"206","205","1","349","1","350"
"207","206","9","5034","9","5043"
"208","207","10","5035","10","5045"
"209","208","6","2912","6","2918"
"210","209","3","1325","3","1328"
"211","210","9","5046","9","5055"
"212","211","5","2929","5","2934"
"213","212","8","4154","8","4162"
"214","213","4","1348","4","1352"
"215","214","8","4164","8","4172"
"216","215","4","1363","4","1367"
"217","216","7","4170","7","4177"
"218","217","1","370","1","371"
"219","218","7","4175","7","4182"
"220","219","10","5068","10","5078"
"221","220","9","5069","9","5078"
"222","221","10","5069","10","5079"
"223","222","8","4188","8","4196"
"224","223","4","1409","4","1413"
"225","224","5","2985","5","2990"
"226","225","9","5076","9","5085"
"227","226","8","4205","8","4213"
"228","227","2","385","2","387"
"229","228","11","5613","11","5624"
"230","229","5","3014","5","3019"
"231","230","5","3024","5","3029"
"232","231","2","392","2","394"
"233","232","8","4230","8","4238"
"234","233","3","1477","3","1480"
"235","234","4","1481","4","1485"
"236","235","10","5095","10","5105"
"237","236","12","5615","12","5627"
"238","237","9","5097","9","5106"
"239","238","10","5100","10","5110"
"240","239","9","5101","9","5110"
"241","240","3","1525","3","1528"
"242","241","5","3078","5","3083"
"243","242","1","413","1","414"
"244","243","5","3087","5","3092"
"245","244","7","4271","7","4278"
"246","245","2","417","2","419"
"247","246","2","420","2","422"
"248","247","2","421","2","423"
"249","248","3","1567","3","1570"
"250","249","4","1576","4","1580"
"251","250","7","4286","7","4293"
"252","251","4","1591","4","1595"
"253","252","7","4298","7","4305"
"254","253","1","433","1","434"
"255","254","4","1608","4","1612"
"256","255","7","4304","7","4311"
"257","256","2","435","2","437"
"258","257","6","3142","6","3148"
"259","258","3","1623","3","1626"
"260","259","2","440","2","442"
"261","260","7","4310","7","4317"
"262","261","3","1647","3","1650"
"263","262","9","5143","9","5152"
"264","263","11","5636","11","5647"
"265","264","4","1667","4","1671"
"266","265","3","1675","3","1678"
"267","266","5","3183","5","3188"
"268","267","8","4344","8","4352"
"269","268","4","1692","4","1696"
"270","269","9","5160","9","5169"
"271","270","6","3205","6","3211"
"272","271","7","4364","7","4371"
"273","272","6","3219","6","3225"
"274","273","4","1731","4","1735"
"275","274","5","3223","5","3228"
"276","275","3","1746","3","1749"
"277","276","7","4373","7","4380"
"278","277","4","1761","4","1765"
"279","278","4","1766","4","1770"
"280","279","2","480","2","482"
"281","280","3","1780","3","1783"
"282","281","2","484","2","486"
"283","282","2","485","2","487"
"284","283","11","5657","11","5668"
"285","284","5","3269","5","3274"
"286","285","4","1816","4","1820"
"287","286","9","5192","9","5201"
"288","287","5","3285","5","3290"
"289","288","7","4405","7","4412"
"290","289","7","4413","7","4420"
"291","290","10","5196","10","5206"
"292","291","4","1858","4","1862"
"293","292","2","503","2","505"
"294","293","9","5201","9","5210"
"295","294","5","3323","5","3328"
"296","295","2","508","2","510"
"297","296","10","5204","10","5214"
"298","297","7","4436","7","4443"
"299","298","8","4441","8","4449"
"300","299","5","3346","5","3351"
"301","300","3","1915","3","1918"
"302","301","3","1919","3","1922"
"303","302","10","5211","10","5221"
"304","303","5","3362","5","3367"
"305","304","4","1940","4","1944"
"306","305","7","4464","7","4471"
"307","306","4","1956","4","1960"
"308","307","9","5220","9","5229"
"309","308","2","532","2","534"
"310","309","11","5665","11","5676"
"311","310","5","3404","5","3409"
"312","311","1","537","1","538"
"313","312","10","5227","10","5237"
"314","313","5","3416","5","3421"
"315","314","3","2003","3","2006"
"316","315","6","3425","6","3431"
"317","316","9","5235","9","5244"
"318","317","7","4506","7","4513"
"319","318","4","2029","4","2033"
"320","319","9","5243","9","5252"
"321","320","10","5245","10","5255"
"322","321","9","5250","9","5259"
"323","322","3","2053","3","2056"
"324","323","1","557","1","558"
"325","324","1","557","1","558"
"326","325","4","2070","4","2074"
"327","326","9","5257","9","5266"
"328","327","12","5675","12","5687"
"329","328","6","3476","6","3482"
"330","329","9","5261","9","5270"
"331","330","7","4548","7","4555"
"332","331","5","3491","5","3496"
"333","332","6","3493","6","3499"
"334","333","12","5680","12","5692"
"335","334","7","4557","7","4564"
"336","335","3","2128","3","2131"
"337","336","8","4558","8","4566"
"338","337","1","574","1","575"
"339","338","2","574","2","576"
"340","339","2","575","2","577"
"341","340","7","4565","7","4572"
"342","341","9","5275","9","5284"
"343","342","2","580","2","582"
"344","343","11","5682","11","5693"
"345","344","11","5686","11","5697"
"346","345","10","5289","10","5299"
"347","346","3","2183","3","2186"
"348","347","7","4597","7","4604"
"349","348","10","5302","10","5312"
"350","349","6","3566","6","3572"
"351","350","5","3575","5","3580"
"352","351","6","3579","6","3585"
"353","352","10","5315","10","5325"
"354","353","11","5693","11","5704"
"355","354","2","603","2","605"
"356","355","11","5698","11","5709"
"357","356","3","2251","3","2254"
"358","357","10","5326","10","5336"
"359","358","10","5333","10","5343"
"360","359","10","5334","10","5344"
"361","360","4","2277","4","2281"
"362","361","8","4657","8","4665"
"363","362","1","617","1","618"
"364","363","6","3641","6","3647"
"365","364","4","2304","4","2308"
"366","365","4","2309","4","2313"
"367","366","1","624","1","625"
"368","367","4","2321","4","2325"
"369","368","4","2326","4","2330"
"370","369","7","4675","7","4682"
"371","370","9","5347","9","5356"
"372","371","5","3673","5","3678"
"373","372","1","633","1","634"
"374","373","4","2339","4","2343"
"375","374","5","3671","5","3676"
"376","375","2","637","2","639"
"377","376","2","638","2","640"
"378","377","8","4676","8","4684"
"379","378","9","5340","9","5349"
"380","379","1","642","1","643"
"381","380","3","2340","3","2343"
"382","381","3","2340","3","2343"
"383","382","11","5688","11","5699"
"384","383","8","4678","8","4686"
"385","384","6","3672","6","3678"
"386","385","7","4678","7","4685"
"387","386","7","4678","7","4685"
"388","387","4","2349","4","2353"
"389","388","6","3676","6","3682"
"390","389","5","3677","5","3682"
"391","390","9","5332","9","5341"
"392","391","8","4677","8","4685"
"393","392","10","5331","10","5341"
"394","393","10","5332","10","5342"
"395","394","6","3683","6","3689"
"396","395","9","5332","9","5341"
"397","396","8","4682","8","4690"
"398","397","6","3688","6","3694"
"399","398","7","4682","7","4689"
"400","399","7","4684","7","4691"
"401","400","6","3693","6","3699"
"402","401","8","4685","8","4693"
"403","402","12","5669","12","5681"
"404","403","4","2378","4","2382"
"405","404","8","4686","8","4694"
"406","405","3","2380","3","2383"
"407","406","11","5667","11","5678"
"408","407","8","4687","8","4695"
"409","408","6","3701","6","3707"
"410","409","2","692","2","694"
"411","410","5","3703","5","3708"
"412","411","4","2387","4","2391"
"413","412","2","697","2","699"
"414","413","1","698","1","699"
"415","414","4","2388","4","2392"
"416","415","1","701","1","702"
"417","416","2","703","2","705"
"418","417","7","4681","7","4688"
"419","418","6","3702","6","3708"
"420","419","8","4680","8","4688"
"421","420","12","5654","12","5666"
"422","421","4","2396","4","2400"
"423","422","12","5654","12","5666"
"424","423","5","3705","5","3710"
"425","424","11","5654","11","5665"
"426","425","4","2400","4","2404"
"427","426","5","3705","5","3710"
"428","427","6","3705","6","3711"
"429","428","5","3706","5","3711"
"430","429","2","724","2","726"
"431","430","9","5310","9","5319"
"432","431","7","4678","7","4685"
"433","432","4","2411","4","2415"
"434","433","9","5308","9","5317"
"435","434","6","3711","6","3717"
"436","435","5","3712","5","3717"
"437","436","9","5306","9","5315"
"438","437","2","740","2","742"
"439","438","11","5641","11","5652"
"440","439","11","5641","11","5652"
"441","440","3","2421","3","2424"
"442","441","6","3715","6","3721"
"443","442","2","749","2","751"
"444","443","9","5304","9","5313"
"445","444","4","2424","4","2428"
"446","445","10","5303","10","5313"
"447","446","11","5635","11","5646"
"448","447","7","4680","7","4687"
"449","448","10","5304","10","5314"
"450","449","10","5305","10","5315"
"451","450","2","764","2","766"
"452","451","2","765","2","767"
"453","452","7","4680","7","4687"
"454","453","2","768","2","770"
"455","454","4","2433","4","2437"
"456","455","9","5301","9","5310"
"457","456","3","2437","3","2440"
"458","457","4","2437","4","2441"
"459","458","6","3723","6","3729"
"460","459","6","3724","6","3730"
"461","460","11","5622","11","5633"
"462","461","6","3728","6","3734"
"463","462","2","787","2","789"
"464","463","6","3730","6","3736"
"465","464","3","2449","3","2452"
"466","465","9","5294","9","5303"
"467","466","4","2452","4","2456"
"468","467","6","3734","6","3740"
"469","468","8","4674","8","4682"
"470","469","2","800","2","802"
"471","470","8","4674","8","4682"
"472","471","9","5289","9","5298"
"473","472","10","5289","10","5299"
"474","473","10","5290","10","5300"
"475","474","2","809","2","811"
"476","475","2","812","2","814"
"477","476","3","2462","3","2465"
"478","477","5","3741","5","3746"
"479","478","8","4676","8","4684"
"480","479","5","3744","5","3749"
"481","480","10","5287","10","5297"
"482","481","8","4679","8","4687"
"483","482","3","2470","3","2473"
"484","483","10","5286","10","5296"
"485","484","2","827","2","829"
"486","485","8","4681","8","4689"
"487","486","7","4682","7","4689"
"488","487","1","832","1","833"
"489","488","3","2473","3","2476"
"490","489","11","5594","11","5605"
"491","490","2","836","2","838"
"492","491","10","5282","10","5292"
"493","492","2","840","2","842"
"494","493","7","4684","7","4691"
"495","494","7","4684","7","4691"
"496","495","10","5280","10","5290"
"497","496","6","3755","6","3761"
"498","497","3","2485","3","2488"
"499","498","2","850","2","852"
"500","499","8","4684","8","4692"
"501","500","4","2487","4","2491"
"502","501","5","3756","5","3761"
"503","502","4","2489","4","2493"
"504","503","11","5581","11","5592"
"505","504","2","859","2","861"
"506","505","9","5274","9","5283"
"507","506","11","5579","11","5590"
"508","507","3","2492","3","2495"
"509","508","7","4683","7","4690"
"510","509","4","2495","4","2499"
"511","510","3","2498","3","2501"
"512","511","2","870","2","872"
"513","512","9","5270","9","5279"
"514","513","11","5573","11","5584"
"515","514","4","2499","4","2503"
"516","515","6","3756","6","3762"
"517","516","3","2501","3","2504"
"518","517","7","4681","7","4688"
"519","518","7","4681","7","4688"
"520","519","2","883","2","885"
"521","520","7","4682","7","4689"
"522","521","6","3763","6","3769"
"523","522","3","2510","3","2513"
"524","523","12","5564","12","5576"
"525","524","2","892","2","894"
"526","525","1","895","1","896"
"527","526","8","4681","8","4689"
"528","527","4","2514","4","2518"
"529","528","7","4681","7","4688"
"530","529","3","2516","3","2519"
"531","530","3","2516","3","2519"
"532","531","3","2518","3","2521"
"533","532","5","3764","5","3769"
"534","533","6","3764","6","3770"
"535","534","10","5257","10","5267"
"536","535","3","2523","3","2526"
"537","536","11","5553","11","5564"
"538","537","2","916","2","918"
"539","538","4","2525","4","2529"
"540","539","11","5551","11","5562"
"541","540","8","4678","8","4686"
"542","541","5","3769","5","3774"
"543","542","1","922","1","923"
"544","543","9","5254","9","5263"
"545","544","9","5254","9","5263"
"546","545","10","5254","10","5264"
"547","546","4","2533","4","2537"
"548","547","3","2536","3","2539"
"549","548","12","5543","12","5555"
"550","549","11","5544","11","5555"
"551","550","3","2538","3","2541"
"552","551","4","2538","4","2542"
"553","552","9","5253","9","5262"
"554","553","10","5253","10","5263"
"555","554","3","2541","3","2544"
"556","555","9","5253","9","5262"
"557","556","8","4682","8","4690"
"558","557","3","2543","3","2546"
"559","558","6","3774","6","3780"
"560","559","11","5535","11","5546"
"561","560","7","4683","7","4690"
"562","561","3","2548","3","2551"
"563","562","12","5533","12","5545"
"564","563","10","5250","10","5260"
"565","564","6","3783","6","3789"
"566","565","6","3784","6","3790"
"567","566","8","4684","8","4692"
"568","567","5","3786","5","3791"
"569","568","8","4684","8","4692"
"570","569","12","5528","12","5540"
"571","570","4","2562","4","2566"
"572","571","11","5528","11","5539"
"573","572","11","5528","11","5539"
"574","573","6","3791","6","3797"
"575","574","8","4687","8","4695"
"576","575","2","980","2","982"
"577","576","11","5525","11","5536"
"578","577","9","5246","9","5255"
"579","578","10","5246","10","5256"
"580","579","10","5247","10","5257"
"581","580","1","991","1","992"
"582","581","7","4690","7","4697"
"583","582","7","4690","7","4697"
"584","583","2","995","2","997"
"585","584","8","4689","8","4697"
"586","585","10","5243","10","5253"
"587","586","8","4691","8","4699"
"588","587","8","4692","8","4700"
"589","588","8","4693","8","4701"
"590","589","3","2585","3","2588"
"591","590","2","1008","2","1010"
"592","591","9","5239","9","5248"
"593","592","9","5239","9","5248"
"594","593","2","1013","2","1015"
"595","594","11","5508","11","5519"
"596","595","6","3809","6","3815"
"597","596","3","2591","3","2594"
"598","597","2","1021","2","1023"
"599","598","3","2592","3","2595"
"600","599","7","4695","7","4702"
"601","600","4","2595","4","2599"
"602","601","11","5502","11","5513"
"603","602","4","2599","4","2603"
"604","603","7","4694","7","4701"
"605","604","4","2601","4","2605"
"606","605","7","4693","7","4700"
"607","606","9","5230","9","5239"
"608","607","10","5230","10","5240"
"609","608","4","2606","4","2610"
"610","609","3","2609","3","2612"
"611","610","7","4694","7","4701"
"612","611","6","3818","6","3824"
"613","612","10","5227","10","5237"
"614","613","8","4694","8","4702"
"615","614","8","4695","8","4703"
"616","615","5","3824","5","3829"
"617","616","11","5488","11","5499"
"618","617","6","3825","6","3831"
"619","618","11","5487","11","5498"
"620","619","4","2624","4","2628"
"621","620","6","3828","6","3834"
"622","621","5","3829","5","3834"
"623","622","10","5224","10","5234"
"624","623","8","4696","8","4704"
"625","624","8","4697","8","4705"
"626","625","7","4698","7","4705"
"627","626","7","4698","7","4705"
"628","627","9","5221","9","5230"
"629","628","11","5478","11","5489"
"630","629","5","3839","5","3844"
"631","630","4","2641","4","2645"
"632","631","3","2642","3","2645"
"633","632","6","3837","6","3843"
"634","633","4","2643","4","2647"
"635","634","12","5473","12","5485"
"636","635","1","1086","1","1087"
"637","636","7","4695","7","4702"
"638","637","5","3838","5","3843"
"639","638","4","2648","4","2652"
"640","639","1","1093","1","1094"
"641","640","1","1095","1","1096"
"642","641","5","3839","5","3844"
"643","642","9","5213","9","5222"
"644","643","3","2653","3","2656"
"645","644","6","3841","6","3847"
"646","645","7","4694","7","4701"
"647","646","6","3845","6","3851"
"648","647","4","2658","4","2662"
"649","648","4","2661","4","2665"
"650","649","4","2662","4","2666"
"651","650","7","4694","7","4701"
"652","651","7","4694","7","4701"
"653","652","2","1116","2","1118"
"654","653","7","4693","7","4700"
"655","654","9","5202","9","5211"
"656","655","10","5202","10","5212"
"657","656","8","4695","8","4703"
"658","657","9","5202","9","5211"
"659","658","10","5202","10","5212"
"660","659","1","1127","1","1128"
"661","660","11","5449","11","5460"
"662","661","3","2674","3","2677"
"663","662","10","5202","10","5212"
"664","663","4","2677","4","2681"
"665","664","7","4697","7","4704"
"666","665","2","1136","2","1138"
"667","666","9","5200","9","5209"
"668","667","10","5200","10","5210"
"669","668","2","1139","2","1141"
"670","669","10","5200","10","5210"
"671","670","4","2680","4","2684"
"672","671","7","4697","7","4704"
"673","672","8","4697","8","4705"
"674","673","8","4698","8","4706"
"675","674","10","5197","10","5207"
"676","675","1","1149","1","1150"
"677","676","10","5197","10","5207"
"678","677","1","1152","1","1153"
"679","678","11","5432","11","5443"
"680","679","7","4700","7","4707"
"681","680","6","3861","6","3867"
"682","681","8","4700","8","4708"
"683","682","5","3865","5","3870"
"684","683","10","5194","10","5204"
"685","684","12","5427","12","5439"
"686","685","3","2698","3","2701"
"687","686","4","2698","4","2702"
"688","687","6","3868","6","3874"
"689","688","12","5425","12","5437"
"690","689","3","2703","3","2706"
"691","690","10","5193","10","5203"
"692","691","4","2704","4","2708"
"693","692","1","1180","1","1181"
"694","693","2","1180","2","1182"
"695","694","1","1181","1","1182"
"696","695","12","5420","12","5432"
"697","696","1","1184","1","1185"
"698","697","2","1184","2","1186"
"699","698","12","5419","12","5431"
"700","699","2","1187","2","1189"
"701","700","9","5189","9","5198"
"702","701","7","4697","7","4704"
"703","702","6","3868","6","3874"
"704","703","2","1193","2","1195"
"705","704","10","5186","10","5196"
"706","705","5","3870","5","3875"
"707","706","2","1200","2","1202"
"708","707","11","5412","11","5423"
"709","708","10","5186","10","5196"
"710","709","11","5411","11","5422"
"711","710","9","5188","9","5197"
"712","711","11","5410","11","5421"
"713","712","6","3880","6","3886"
"714","713","7","4700","7","4707"
"715","714","3","2726","3","2729"
"716","715","10","5187","10","5197"
"717","716","1","1219","1","1220"
"718","717","9","5187","9","5196"
"719","718","6","3884","6","3890"
"720","719","12","5403","12","5415"
"721","720","1","1223","1","1224"
"722","721","6","3885","6","3891"
"723","722","11","5402","11","5413"
"724","723","5","3887","5","3892"
"725","724","8","4700","8","4708"
"726","725","3","2733","3","2736"
"727","726","11","5399","11","5410"
"728","727","3","2736","3","2739"
"729","728","3","2736","3","2739"
"730","729","2","1237","2","1239"
"731","730","10","5181","10","5191"
"732","731","5","3890","5","3895"
"733","732","9","5181","9","5190"
"734","733","10","5181","10","5191"
"735","734","11","5392","11","5403"
"736","735","6","3895","6","3901"
"737","736","9","5182","9","5191"
"738","737","10","5182","10","5192"
"739","738","2","1256","2","1258"
"740","739","10","5182","10","5192"
"741","740","1","1260","1","1261"
"742","741","1","1260","1","1261"
"743","742","5","3898","5","3903"
"744","743","10","5180","10","5190"
"745","744","1","1264","1","1265"
"746","745","2","1264","2","1266"
"747","746","11","5381","11","5392"
"748","747","4","2755","4","2759"
"749","748","2","1271","2","1273"
"750","749","8","4699","8","4707"
"751","750","6","3897","6","3903"
"752","751","7","4699","7","4706"
"753","752","12","5376","12","5388"
"754","753","5","3901","5","3906"
"755","754","5","3901","5","3906"
"756","755","4","2764","4","2768"
"757","756","10","5173","10","5183"
"758","757","2","1287","2","1289"
"759","758","6","3900","6","3906"
"760","759","3","2766","3","2769"
"761","760","11","5370","11","5381"
"762","761","3","2768","3","2771"
"763","762","3","2768","3","2771"
"764","763","6","3899","6","3905"
"765","764","4","2769","4","2773"
"766","765","12","5366","12","5378"
"767","766","1","1303","1","1304"
"768","767","10","5168","10","5178"
"769","768","2","1304","2","1306"
"770","769","10","5168","10","5178"
"771","770","10","5169","10","5179"
"772","771","9","5170","9","5179"
"773","772","1","1310","1","1311"
"774","773","7","4694","7","4701"
"775","774","11","5359","11","5370"
"776","775","5","3905","5","3910"
"777","776","10","5169","10","5179"
"778","777","10","5170","10","5180"
"779","778","3","2783","3","2786"
"780","779","4","2783","4","2787"
"781","780","11","5354","11","5365"
"782","781","8","4697","8","4705"
"783","782","9","5169","9","5178"
"784","783","5","3910","5","3915"
"785","784","2","1333","2","1335"
"786","785","5","3909","5","3914"
"787","786","10","5166","10","5176"
"788","787","6","3911","6","3917"
"789","788","8","4697","8","4705"
"790","789","6","3913","6","3919"
"791","790","7","4697","7","4704"
"792","791","2","1346","2","1348"
"793","792","10","5162","10","5172"
"794","793","7","4699","7","4706"
"795","794","4","2806","4","2810"
"796","795","6","3920","6","3926"
"797","796","3","2808","3","2811"
"798","797","5","3920","5","3925"
"799","798","3","2809","3","2812"
"800","799","10","5157","10","5167"
"801","800","3","2812","3","2815"
"802","801","1","1364","1","1365"
"803","802","5","3921","5","3926"
"804","803","8","4694","8","4702"
"805","804","12","5331","12","5343"
"806","805","5","3923","5","3928"
"807","806","7","4695","7","4702"
"808","807","3","2819","3","2822"
"809","808","9","5152","9","5161"
"810","809","2","1377","2","1379"
"811","810","11","5327","11","5338"
"812","811","5","3927","5","3932"
"813","812","1","1384","1","1385"
"814","813","4","2826","4","2830"
"815","814","5","3929","5","3934"
"816","815","6","3929","6","3935"
"817","816","9","5147","9","5156"
"818","817","2","1392","2","1394"
"819","818","6","3930","6","3936"
"820","819","6","3931","6","3937"
"821","820","3","2834","3","2837"
"822","821","11","5317","11","5328"
"823","822","3","2835","3","2838"
"824","823","10","5143","10","5153"
"825","824","3","2836","3","2839"
"826","825","7","4692","7","4699"
"827","826","9","5142","9","5151"
"828","827","6","3935","6","3941"
"829","828","7","4692","7","4699"
"830","829","1","1414","1","1415"
"831","830","9","5139","9","5148"
"832","831","6","3937","6","3943"
"833","832","5","3938","5","3943"
"834","833","6","3939","6","3945"
"835","834","8","4689","8","4697"
"836","835","8","4690","8","4698"
"837","836","5","3942","5","3947"
"838","837","8","4690","8","4698"
"839","838","6","3943","6","3949"
"840","839","11","5300","11","5311"
"841","840","5","3947","5","3952"
"842","841","11","5299","11","5310"
"843","842","5","3948","5","3953"
"844","843","7","4691","7","4698"
"845","844","10","5130","10","5140"
"846","845","4","2866","4","2870"
"847","846","11","5295","11","5306"
"848","847","2","1444","2","1446"
"849","848","3","2867","3","2870"
"850","849","6","3950","6","3956"
"851","850","6","3951","6","3957"
"852","851","3","2870","3","2873"
"853","852","4","2872","4","2876"
"854","853","3","2873","3","2876"
"855","854","12","5288","12","5300"
"856","855","7","4690","7","4697"
"857","856","7","4690","7","4697"
"858","857","11","5287","11","5298"
"859","858","11","5287","11","5298"
"860","859","2","1463","2","1465"
"861","860","4","2878","4","2882"
"862","861","11","5285","11","5296"
"863","862","6","3955","6","3961"
"864","863","2","1470","2","1472"
"865","864","8","4690","8","4698"
"866","865","4","2885","4","2889"
"867","866","8","4690","8","4698"
"868","867","11","5280","11","5291"
"869","868","5","3960","5","3965"
"870","869","12","5279","12","5291"
"871","870","6","3961","6","3967"
"872","871","8","4691","8","4699"
"873","872","1","1486","1","1487"
"874","873","11","5277","11","5288"
"875","874","4","2896","4","2900"
"876","875","9","5118","9","5127"
"877","876","11","5275","11","5286"
"878","877","10","5119","10","5129"
"879","878","11","5274","11","5285"
"880","879","6","3972","6","3978"
"881","880","4","2906","4","2910"
"882","881","1","1503","1","1504"
"883","882","8","4696","8","4704"
"884","883","7","4697","7","4704"
"885","884","2","1505","2","1507"
"886","885","2","1508","2","1510"
"887","886","2","1509","2","1511"
"888","887","11","5266","11","5277"
"889","888","9","5114","9","5123"
"890","889","9","5114","9","5123"
"891","890","2","1517","2","1519"
"892","891","2","1520","2","1522"
"893","892","2","1521","2","1523"
"894","893","12","5261","12","5273"
"895","894","5","3979","5","3984"
"896","895","9","5113","9","5122"
"897","896","11","5260","11","5271"
"898","897","11","5260","11","5271"
"899","898","4","2924","4","2928"
"900","899","7","4700","7","4707"
"901","900","2","1537","2","1539"
"902","901","2","1538","2","1540"
"903","902","11","5256","11","5267"
"904","903","2","1542","2","1544"
"905","904","9","5113","9","5122"
"906","905","2","1546","2","1548"
"907","906","10","5112","10","5122"
"908","907","4","2930","4","2934"
"909","908","3","2933","3","2936"
"910","909","2","1554","2","1556"
"911","910","1","1556","1","1557"
"912","911","9","5109","9","5118"
"913","912","8","4698","8","4706"
"914","913","5","3987","5","3992"
"915","914","2","1561","2","1563"
"916","915","3","2935","3","2938"
"917","916","9","5105","9","5114"
"918","917","6","3986","6","3992"
"919","918","7","4696","7","4703"
"920","919","8","4696","8","4704"
"921","920","7","4697","7","4704"
"922","921","2","1572","2","1574"
"923","922","3","2943","3","2946"
"924","923","12","5236","12","5248"
"925","924","9","5100","9","5109"
"926","925","10","5100","10","5110"
"927","926","7","4699","7","4706"
"928","927","11","5234","11","5245"
"929","928","3","2950","3","2953"
"930","929","12","5233","12","5245"
"931","930","10","5103","10","5113"
"932","931","1","1587","1","1588"
"933","932","8","4706","8","4714"
"934","933","4","2956","4","2960"
"935","934","12","5230","12","5242"
"936","935","8","4707","8","4715"
"937","936","10","5101","10","5111"
"938","937","8","4709","8","4717"
"939","938","6","4009","6","4015"
"940","939","12","5227","12","5239"
"941","940","9","5101","9","5110"
"942","941","6","4012","6","4018"
"943","942","5","4015","5","4020"
"944","943","7","4711","7","4718"
"945","944","1","1610","1","1611"
"946","945","9","5097","9","5106"
"947","946","5","4018","5","4023"
"948","947","8","4711","8","4719"
"949","948","11","5220","11","5231"
"950","949","8","4713","8","4721"
"951","950","4","2984","4","2988"
"952","951","9","5094","9","5103"
"953","952","11","5217","11","5228"
"954","953","7","4715","7","4722"
"955","954","5","4025","5","4030"
"956","955","4","2991","4","2995"
"957","956","11","5214","11","5225"
"958","957","6","4027","6","4033"
"959","958","10","5093","10","5103"
"960","959","3","2997","3","3000"
"961","960","11","5211","11","5222"
"962","961","6","4029","6","4035"
"963","962","4","3001","4","3005"
"964","963","11","5209","11","5220"
"965","964","8","4719","8","4727"
"966","965","2","1645","2","1647"
"967","966","4","3003","4","3007"
"968","967","3","3006","3","3009"
"969","968","8","4719","8","4727"
"970","969","7","4721","7","4728"
"971","970","9","5088","9","5097"
"972","971","5","4039","5","4044"
"973","972","1","1658","1","1659"
"974","973","3","3015","3","3018"
"975","974","12","5199","12","5211"
"976","975","11","5200","11","5211"
"977","976","5","4041","5","4046"
"978","977","6","4041","6","4047"
"979","978","2","1669","2","1671"
"980","979","5","4043","5","4048"
"981","980","3","3021","3","3024"
"982","981","5","4042","5","4047"
"983","982","7","4719","7","4726"
"984","983","6","4043","6","4049"
"985","984","1","1679","1","1680"
"986","985","8","4718","8","4726"
"987","986","8","4719","8","4727"
"988","987","3","3029","3","3032"
"989","988","12","5188","12","5200"
"990","989","3","3030","3","3033"
"991","990","4","3030","4","3034"
"992","991","11","5187","11","5198"
"993","992","2","1694","2","1696"
"994","993","10","5074","10","5084"
"995","994","12","5185","12","5197"
"996","995","6","4047","6","4053"
"997","996","6","4048","6","4054"
"998","997","4","3037","4","3041"
"999","998","8","4717","8","4725"
"1000","999","9","5072","9","5081"
"aveW","aveT","aveB","totalB","totalT"
"3378.503944","3375.135","6.191","6191.0","0.0"
